1001夜	1001	夜
100%Pure	100	pure
3C配件	3c	配件
3zu足装秀	3zu	足装秀
7000年	7000	年
8th pink	8th	pink
999王妃	999	王妃
ABC卫生巾	abc	卫生巾
ABC童鞋	abc	童鞋
AFU阿芙	afu	阿芙
A‘Gensn	a	gensn
Alexandra MacQueen	alexandra	macqueen
ALICE&JACKY	alice	jacky
Alpha_Hydrox	alpha	hydrox
Ampai`s	ampai	s
AUSWEAR SHOES	auswear	shoes
AVRIL MONG	avril	mong
b+ab	b	ab
Balance柏莉诗	balance	柏莉诗
BAY HOUSE	bay	house
Be_Beauty	be	beauty
Beermmay/百魅	beermmay	百魅
Betsey Johnson	betsey	johnson
Bio-E	bio	e
BOB-HOME	bob	home
Bottega Veneta	bottega	veneta
B:TREAT	b	treat
by-health	by	health
Calvin Klein	calvin	klein
Carlo Pignatelli	carlo	pignatelli
CECILIA BILANCI	cecilia	bilanci
CE本草	ce	本草
CF药妆	cf	药妆
CHA:LAB	cha	lab
cherry chau	cherry	chau
China Glaze	china	glaze
cici-shop	cici	shop
CJ_LION	cj	lion
CK Underwear	ck	underwear
Clasified/Soda	clasified	soda
COCO FEEL	coco	feel
CO_E	co	e
Commerce-gate	commerce	gate
COMPLEX BIZ	complex	biz
Costume National	costume	national
CP-1	cp	1
C-time	c	time
cucu pot	cucu	pot
C-UK	c	uk
DC-Life	dc	life
DEJAVU Fiberwig	dejavu	fiberwig
de-luxe	de	luxe
Dent-Inn	dent	inn
D-ID	d	id
Dior眼镜	dior	眼镜
DIY玩具	diy	玩具
Dolce_Gabbana	dolce	gabbana
DONG-E	dong	e
DrCi:Labo	drci	labo
Dr_Jart+	dr	jart
DR.JOU	dr	jou
DrLewin’s	drlewin	s
DR-LINE	dr	line
Dr.MJ	dr	mj
DrN+LAB	drn	lab
Dr.Oasis	dr	oasis
DR.WU	dr	wu
D二次方	d	二次方
EAORON耀妆	eaoron	耀妆
eco-more	eco	more
EDC ESPRIT	edc	esprit
Edition_NUMERO	edition	numero
Egyptian_Magic	egyptian	magic
E-JIAO	e	jiao
Elisabetta Franchi	elisabetta	franchi
ELLE HOMME	elle	homme
Elle手表	elle	手表
Esthe Dew	esthe	dew
FANCY CHIC	fancy	chic
FANCY ONLINE	fancy	online
FGF-1	fgf	1
FIVE PIUS	five	pius
Flow-fushi	flow	fushi
Foot-Medi	foot	medi
FS/NY	fs	ny
GLM女装	glm	女装
GoodSkin Labs	goodskin	labs
Grandma‘s	grandma	s
Green Sprouts	green	sprouts
G-STAR	g	star
GUCCI眼镜	gucci	眼镜
Guy/Top	guy	top
HADA RiKi	hada	riki
Harman/Kardon	harman	kardon
Hata矿泉	hata	矿泉
Hello Kitty	hello	kitty
hellomika米卡	hellomika	米卡
HERB-TALE	herb	tale
Hi-power	hi	power
HUGO_BOSS	hugo	boss
Ice-Watch	ice	watch
I-DOU	i	dou
IPAD保护套	ipad	保护套
iphone配件	iphone	配件
it's skin	its	skin
itty-bitty	itty	bitty
J.DEL	j	del
Jean-Paul	jean	paul
jeep小童	jeep	小童
Jennifer_Lopez	jennifer	lopez
J.Lo	j	lo
JRS　CORPORATION	jrs	corporation
Jungyoonki_Special	jungyoonki	special
just bb	just	bb
Just cavalli	just	cavalli
Just kiss	just	kiss
kate&Co	kate	co
KATE SPADE	kate	spade
KATE WILLIAM	kate	william
Kenneth Cole	kenneth	cole
Kiehl’s	kiehl	s
Knight & Princess	knight	princess
kobayashi小林	kobayashi	小林
Kong_style	kong	style
K-Palette	k	palette
la_isla	la	isla
La Pulovce	la	pulovce
LATEEN IRIS	lateen	iris
L’AVER	l	aver
LED灯	led	灯
Le Saunda	le	saunda
Linea Rosa	linea	rosa
LI－NING	li	ning
Liu Jo	liu	jo
L.Mansse	l	mansse
L’OCCITANE	l	occitane
loyer.mod	loyer	mod
L’SPHERE	l	sphere
LUNA.C	luna	c
Lux-girl	lux	girl
Lux-man	lux	man
mama´s	mama	s
MARCY&LANDRY	marcy	landry
marie claire	marie	claire
Mario Badescu	mario	badescu
Megi's Gift	megis	gift
MICHAEL KORS	michael	kors
Mi-Pac	mi	pac
MISS FACE	miss	face
MISS.R	miss	r
mk国际	mk	国际
mod’s	mod	s
Multi-Mam	multi	mam
myjing-o	myjing	o
Native shoes	native	shoes
natural design	natural	design
NATURALLY JOJO	naturally	jojo
Neal’s	neal	s
Nine west	nine	west
N＇JILL	n	jill
Nu-Lax	nu	lax
NY&Co	ny	co
of-gentle	of	gentle
OK BABY	ok	baby
Oléronn	ol	ronn
O‘LYSEE	o	lysee
OMG*CHIC	omg	chic
Oops!J	oops	j
Oral-B	oral	b
Origin/Bamboo	origin	bamboo
Palmer’s	palmer	s
Persian Rose	persian	rose
PETERSON_FARMS	peterson	farms
polo衫	polo	衫
PORSCHE DESIGN	porsche	design
Pure＆Basic	pure	basic
Q-AND	q	and
Q-FACE	q	face
Q版香水	q	版香水
RASTAR·BABY	rastar	baby
RE:CIPE	re	cipe
ROCHE-POSAY	roche	posay
rohto制药	rohto	制药
Rosebud Smiths	rosebud	smiths
SAINT LASURENT	saint	lasurent
Salvatore Ferragamo	salvatore	ferragamo
Scholls/Caleres	scholls	caleres
Seatree-art	seatree	art
Seche Vite	seche	vite
SEXY LOOK	sexy	look
SK-II	sk	ii
SKIN FACTORY	skin	factory
skin holic	skin	holic
so‘bio	so	bio
Spa treatment	spa	treatment
special饰品	special	饰品
Spenco/Implus	spenco	implus
Spring Leaf	spring	leaf
StriVectin-SD	strivectin	sd
STYLE&CO	style	co
STYLE NANNA	style	nanna
su:m37	su	m37
SUPER GLOSS	super	gloss
sweet维恬	sweet	维恬
swiss royal	swiss	royal
swiss vital	swiss	vital
TANGLE TEEZER	tangle	teezer
Ted Baker	ted	baker
The_Namir	the	namir
The-skinshop	the	skinshop
TODS TOTAL	tods	total
Tommy Hilfiger	tommy	hilfiger
To-plan	to	plan
TO-PLAN	to	plan
Tory Burch	tory	burch
UNES优理氏	unes	优理氏
UNITED NUDE	united	nude
U-quai	u	quai
Vida/Esprit	vida	esprit
Vivienne Westwood	vivienne	westwood
Voulez-Vous	voulez	vous
W.DIVA	w	diva
Well_Fon	well	fon
x-rite	x	rite
X-SOCKS	x	socks
YA-MAN	ya	man
Your-d	your	d
ZACCARO&NICCOLO	zaccaro	niccolo
一生之水	一生	之水
一笔成型	一笔	成型
一诺美Inneov	一诺美	inneov
一饮而尽	一饮	而尽
七分裤袜	七分裤	袜
七匹狼休闲	七匹狼	休闲
七匹狼皮具	七匹狼	皮具
七月木槿	七月	木槿
万能工匠	万能	工匠
三只松鼠	三只	松鼠
三效合一	三效	合一
三星物产	三星	物产
三水之源	三水	之源
三洋电器	三洋	电器
三轮推车	三轮	推车
上品嘉人	上品	嘉人
上海女人	上海	女人
上海故事	上海	故事
不易脱妆	不易	脱妆
世界最好	世界	最好
丛林奇兵	丛林	奇兵
东方宝石	东方	宝石
东方神骑	东方神	骑
东阿阿胶	东阿	阿胶
两色可选	两色	可选
个人护理	个人	护理
中国娃娃	中国	娃娃
中外制药	中外	制药
中性香水	中性	香水
丰胸食品	丰胸	食品
丹尼尔惠灵顿	丹尼尔	惠灵顿
乌龟海岸	乌龟	海岸
乐器相关	乐器	相关
乐扣乐扣	乐扣	乐扣
乐高家居	乐高	家居
乒乓球拍	乒乓球	拍
乔治·阿玛尼	乔治	阿玛尼
九分裤袜	九分裤	袜
九朵云X	九朵云	x
于MOMO	于	momo
云南白药	云南	白药
云朵面包	云朵	面包
五分裤袜	五分	裤袜
五星玩具	五星	玩具
五谷磨房	五谷	磨房
亚洲妈妈	亚洲	妈妈
产后塑身	产后	塑身
京润珍珠	京	润珍珠
京都尚品	京都	尚品
亲子读物	亲子	读物
仿皮皮衣	仿皮	皮衣
仿真模型	仿真	模型
企鹅卫队	企鹅	卫队
伊丽莎白雅顿	伊丽莎白	雅顿
休闲帆布鞋	休闲	帆布鞋
休闲玩具	休闲	玩具
休闲长裤	休闲	长裤
优雅主妇	优雅	主妇
伦敦男孩	伦敦	男孩
伯爵卓尔	伯爵	卓尔
似水年华	似	水年华
低调女人	低调	女人
体内调节	体内	调节
你好，熊猫	你好	熊猫
你的故事	你的	故事
俏皮娃娃	俏皮	娃娃
保健补钙	保健	补钙
保加利亚医药集团	保加利亚	医药集团
保暖内衣	保暖	内衣
保暖套装	保暖	套装
保温保鲜	保温	保鲜
保罗马球	保罗	马球
修护肌肤	修护	肌肤
偌水rosy	偌水	rosy
健康护理	健康	护理
健身器材	健身器	材
健身娱乐	健身	娱乐
健身玩具	健身	玩具
儿童内衣裤	儿童	内衣裤
儿童凉席	儿童	凉席
儿童套件	儿童	套件
儿童寝具	儿童	寝具
儿童 浴帽	儿童	浴帽
儿童溜冰鞋	儿童	溜冰鞋
儿童背包	儿童	背包
儿童裤子	儿童裤	子
兆林童装	兆林	童装
光合生活	光合	生活
光面文胸	光面	文胸
免洗面膜	免洗	面膜
全棉时代	全棉	时代
公牛巨人	公牛	巨人
其他品牌	其他	品牌
其他配饰	其他	配饰
内衣套装	内衣	套装
内衣配件	内衣	配件
农庄生机	农庄	生机
冲上云霄	冲上	云霄
冲绳酵素	冲绳	酵素
净化除味	净化	除味
净颜小筑	净颜	小筑
凉席套件	凉席	套件
减压玩具	减压	玩具
几何部落	几何	部落
凡尔赛玫瑰	凡尔赛	玫瑰
凯特之家	凯特	之家
凯特莫斯	凯特	莫斯
凯莉·米洛	凯莉	米洛
出行装备	出行	装备
分体泳衣	分体	泳衣
创意减压	创意	减压
创意玩具	创意	玩具
功夫熊猫	功夫	熊猫
功能用品	功能	用品
功能箱包	功能	箱包
加州宝宝	加州	宝宝
加州宝贝	加州	宝贝
动漫玩具	动漫	玩具
北川本家	北川	本家
北海大和	北海	大和
北纬30°	北纬	30
北美电器	北美	电器
医护美容	医护	美容
十二月坊	十二月	坊
十月天使	十月	天使
十月妈咪	十月	妈咪
十月结晶	十月	结晶
千艺彩妆	千艺	彩妆
千艺老银匠	千艺	老银匠
千足珍珠	千足	珍珠
单人蚊帐	单人	蚊帐
单方精油	单方	精油
南极人童装	南极人	童装
博洋家纺	博洋	家纺
博闻天下	博闻	天下
卡尔文•克莱恩	卡尔文	克莱恩
卡帝乐鳄鱼	卡帝乐	鳄鱼
卡文克莱	卡文	克莱
卡瓦亲Cover	卡瓦亲	cover
卡罗Kaloo	卡罗	kaloo
卡莫斯Acaci	卡莫斯	acaci
卡通周边	卡通	周边
卫浴用品	卫浴	用品
印象童年	印象	童年
卸妆洁面	卸妆	洁面
原宿娃娃	原宿	娃娃
厨房剪刀	厨房	剪刀
厨房收纳	厨房	收纳
去橘皮组织	去橘皮	组织
去黑眼圈	去	黑眼圈
双人蚊帐	双人	蚊帐
双星名人	双星	名人
双肩背包	双肩背	包
双胞胎推车	双胞胎	推车
发朵Phyto	发朵	phyto
发育助长	发育	助长
发饰/首饰	发饰	首饰
口水巾、罩衣	口水巾	罩衣
口腔护理	口腔	护理
古今男士	古今	男士
古奇天伦	古奇	天伦
古老鲨鱼	古老	鲨鱼
可可佳人	可可	佳人
可可贝拉	可可	贝拉
可瑞康羊奶	可瑞康	羊奶
台湾啤酒	台湾	啤酒
合成宝石	合成	宝石
吉他贝斯	吉他	贝斯
吊带背心	吊带	背心
同一方向	同一	方向
名门闺秀	名门	闺秀
咕噜日记	咕噜	日记
哈佛博士	哈佛	博士
唇部去角质	唇部	去角质
唇部护理	唇部	护理
唇部精华	唇部	精华
商务休闲	商务	休闲
商务公文包	商务	公文包
商务正装	商务	正装
喂养用品	喂养	用品
嘉娜宝Kracie	嘉娜宝	kracie
四轮推车	四轮	推车
图书音像	图书	音像
圣地亚哥保罗	圣地亚哥	保罗
地毯/地垫	地毯	地垫
均匀肤色	均匀	肤色
坡跟凉鞋	坡跟	凉鞋
坡跟单鞋	坡跟	单鞋
埃及魔法	埃及	魔法
埃菲尔铁塔	埃菲尔	铁塔
城市丽人	城市	丽人
基本护理	基本	护理
基本生活	基本	生活
基础保健	基础	保健
基础内衣	基础	内衣
基础精油	基础	精油
塑身上衣	塑身	上衣
塑身连体衣	塑身	连体衣
复方精油	复方	精油
夏依Summer's	夏依	summers
夏尔.贝洛	夏尔	贝洛
外出用品	外出用	品
外套/夹克	外套	夹克
外带咖啡厅	外带	咖啡厅
多功能包	多功能	包
多功能垫	多功能	垫
多功能马甲	多功能	马甲
大力水手	大力	水手
大洋洲袋鼠	大洋洲	袋鼠
大豆食品	大豆	食品
大达地垫	大达	地垫
大高酵素	大高	酵素
天然乳胶	天然	乳胶
天然水晶	天然水	晶
天然物语	天然	物语
天鹅绒家居服	天鹅绒	家居服
太平公主	太平	公主
太平鸟女装	太平鸟	女装
套装礼盒	套装	礼盒
奢华宝贝	奢华	宝贝
奥莎迪Oshadhi	奥莎迪	oshadhi
女优Mode	女优	mode
女士内裤	女士	内裤
女士手套	女士	手套
女士湿巾	女士	湿巾
女士钱包	女士	钱包
女性护理	女性	护理
女性调养	女性	调养
女打底衫	女打底	衫
女打底裤	女打底	裤
女款运动袜	女款	运动袜
女的欲望	女的	欲望
女神新装	女神	新装
女针织衫	女针织	衫
奶瓶清洁	奶瓶	清洁
好奇跨境	好奇	跨境
如厕用品	如厕	用品
妆点女人	妆点	女人
妈咪呢喃	妈咪	呢喃
妈咪宝贝	妈咪	宝贝
妈妈专区	妈妈	专区
妈妈奶粉	妈妈	奶粉
妈妈护理	妈妈	护理
妈妈美容	妈妈美	容
妮卡贝尔	妮卡	贝尔
姗拉娜sunrana	姗拉娜	sunrana
威丝曼之家	威丝曼	之家
威娜WELLA	威娜	wella
威登保罗	威登	保罗
娜帕蒂卡	娜	帕蒂卡
娜芙娜芙	娜芙	娜芙
婚纱/礼服	婚纱	礼服
婴儿体温计	婴儿	体温计
婴儿内衣	婴儿	内衣
婴儿推车	婴儿	推车
婴儿理发器	婴儿	理发器
婴儿监视器	婴儿	监视器
婴儿礼盒	婴儿	礼盒
婴幼儿纺织品	婴幼儿	纺织品
孕产妇保健	孕产妇	保健
孕妇内衣	孕妇	内衣
孕妇食品	孕妇	食品
孕期营养	孕期	营养
学步鞋/婴儿鞋	学步鞋	婴儿鞋
安丽尼卡	安丽	尼卡
安全座椅	安全	座椅
安全避孕	安全	避孕
安全防护	安全	防护
安妮大道	安妮	大道
安娜亚马逊	安娜	亚马逊
安安金纯	安安	金纯
安抚奶嘴	安抚	奶嘴
安达露丝	安达	露丝
完美曲线	完美	曲线
定格印痕	定格	印痕
宛如新生	宛如	新生
宝宝护肤	宝宝	护肤
宝宝驱蚊	宝宝	驱蚊
宝艺BONANZA	宝艺	bonanza
宝贝优选	宝贝	优选
宝贝心语	宝贝	心语
宝贝恩赐	宝贝	恩赐
宝贝第一	宝贝	第一
宠爱之名	宠爱	之名
宠物主粮	宠物	主粮
宠物家居	宠物	家居
宠物服饰	宠物	服饰
宠物牵引	宠物	牵引
宠物零食	宠物	零食
宠物驱虫	宠物	驱虫
家居护理	家居	护理
家居日用	家居	日用
家居生活用品	家居生活	用品
家居饰品配件	家居饰品	配件
密丝佛陀	密丝	佛陀
富思伊娃	富思	伊娃
封面女郎	封面	女郎
小叶紫檀	小叶	紫檀
小林制药	小林	制药
少女文胸	少女	文胸
尿布/尿垫	尿布	尿垫
尿裤湿巾	尿裤	湿巾
居室清洁	居室	清洁
居室香薰	居室	香薰
岁月如歌	岁月	如歌
工艺礼品乐器	工艺礼品	乐器
左右缤纷	左右	缤纷
巨型一号	巨型	一号
巴巴童鞋	巴巴	童鞋
巴斯克林	巴斯克	林
巴比乐乐	巴比	乐乐
巴黎世家	巴黎	世家
巴黎恋人	巴黎	恋人
巴黎欧莱雅	巴黎	欧莱雅
巴黎绯黛	巴黎	绯黛
巴黎罗莎	巴黎	罗莎
巴黎蓝色	巴黎	蓝色
布丁派对	布丁	派对
布朗博士	布朗	博士
帝皇蜂姿	帝皇蜂	姿
干洗喷雾	干洗	喷雾
年轻原理	年轻	原理
幸福妈咪	幸福	妈咪
幻彩流星	幻彩	流星
幻金凝彩	幻金	凝彩
幼教早教	幼教	早教
床品套件	床品	套件
床垫/床褥	床垫	床褥
应急救援	应急	救援
度假小姐	度假	小姐
座垫脚垫	座垫	脚垫
康宁餐具	康宁	餐具
康恩贝君宝康	康恩贝	君宝康
康恩贝萃芙理	康恩贝	萃芙理
异域风情	异域	风情
弗蕾娅.西芙	弗蕾娅	西芙
强健骨骼	强健	骨骼
当若无其事	当	若无其事
彩妆套装	彩妆套	装
彩妆工具	彩妆	工具
德国世家	德国	世家
德国女孩	德国	女孩
德国小甘菊	德国	小甘菊
心有猛虎	心有	猛虎
急救美人	急救	美人
恋爱魔镜	恋爱	魔镜
恒源祥内衣	恒源祥	内衣
悦丝YESI	悦丝	yesi
情侣内裤	情侣	内裤
情侣套装	情侣	套装
情侣手套	情侣	手套
情侣装泳衣	情侣装	泳衣
情景玩具	情景	玩具
慕驰MUCHI	慕驰	muchi
慢回弹记忆	慢回弹	记忆
戏剧人生	戏剧	人生
戏水玩具	戏水	玩具
成人尿裤	成人	尿裤
成长卫士	成长	卫士
我是大美人	我是	大美人
我的心机	我的	心机
战地吉普	战地	吉普
户外仪表	户外	仪表
户外工具	户外	工具
户外拖鞋	户外	拖鞋
户外服装	户外服	装
户外照明	户外	照明
户外玩具	户外	玩具
户外装备	户外装	备
户外配件	户外	配件
手工彩泥	手工	彩泥
手机保护套	手机	保护套
手臂浮圈	手臂	浮圈
手足护理	手足	护理
手部护理	手部	护理
打底抹胸	打底	抹胸
护发精华	护发	精华
护理按摩	护理	按摩
护理用品	护理	用品
护肤套装	护肤	套装
护肤工具	护肤	工具
抱枕/腰靠	抱枕	腰靠
拖把配件	拖把	配件
拖拉玩具	拖拉	玩具
拨拨小姐	拨拨	小姐
拾光日记	拾光	日记
挂件/摆件	挂件	摆件
挂钩/毛巾架	挂钩	毛巾架
挪威小鱼	挪威	小鱼
提亮肤色	提亮	肤色
摆件挂件	摆件	挂件
摇铃、床铃	摇铃	床铃
摩卡天空	摩卡	天空
摩洛哥油	摩洛哥	油
撕拉面膜	撕拉	面膜
收敛毛孔	收敛	毛孔
收纳保鲜	收纳	保鲜
收纳用品	收纳	用品
收细毛孔	收	细毛孔
收藏爱好	收藏	爱好
改善肤质	改善	肤质
散粉/蜜粉	散粉	蜜粉
整理收纳	整理	收纳
整理生活	整理	生活
新光饰品	新光	饰品
方向盘套	方向盘	套
旅游用品	旅游	用品
旅行包套装	旅行包	套装
旅行配件	旅行	配件
无印良品	无印	良品
无心卷纸	无心	卷纸
日东制药	日东	制药
日光倾城	日光	倾城
日夜奇迹	日夜	奇迹
日常休闲	日常	休闲
日常护理	日常	护理
日本万代	日本	万代
日本年糕	日本	年糕
日本金兔子	日本	金兔子
时光巴士	时光	巴士
时光恋人	时光	恋人
时尚休闲	时尚	休闲
时尚单鞋	时尚	单鞋
时尚印记	时尚	印记
昂贵公主	昂贵	公主
星座传奇	星座	传奇
星期四农庄	星期四	农庄
春寒食品	春寒	食品
暖宝宝牌	暖宝宝	牌
曼黛玛琏	曼黛玛	琏
最佳伴侣	最佳	伴侣
最受欢迎	最受	欢迎
最流行的	最流行	的
有声挂图	有声	挂图
有机花园	有机	花园
朝日啤酒	朝日	啤酒
木之秘密	木之	秘密
木槿小窝	木槿	小窝
木马智慧	木马	智慧
朵朵拉DODORA	朵朵拉	dodora
朵朵贝儿	朵朵	贝儿
机器人、电动	机器人	电动
杉杉FIRS	杉杉	firs
杰克吉尔	杰克	吉尔
杰米小熊	杰米	小熊
杰西卡布丁	杰西卡	布丁
枕头/枕芯	枕头	枕芯
枕套/枕巾	枕套	枕巾
果漾美人	果漾	美人
格兰宝石	格兰	宝石
格林博士	格林	博士
桃丝熊TOUS	桃丝熊	tous
梦中情人	梦中	情人
梦境成真	梦境	成真
梦娜世家	梦娜	世家
梦游仙境	梦游	仙境
梦特娇家居	梦特娇	家居
棉花公园	棉花	公园
棉花共和国	棉花	共和国
棉衣棉服	棉衣	棉服
森田药妆	森田	药妆
模型玩具	模型	玩具
樱桃小镇	樱桃	小镇
樱桃爷爷	樱桃	爷爷
樱花物语	樱花	物语
橙色炸弹	橙色	炸弹
欧榄Olivia	欧榄	olivia
欧诗曼锦	欧诗曼	锦
歌剧魅影	歌剧	魅影
正装长裤	正装	长裤
步履不停	步履	不停
母婴健康	母婴	健康
毛呢外套	毛呢	外套
毛呢大衣	毛呢	大衣
毛巾套装	毛巾	套装
毛巾家纺	毛巾	家纺
毛球修剪器	毛球	修剪器
毛绒布艺	毛绒	布艺
毛衣/针织衫	毛衣	针织衫
毯子、毛巾被	毯子	毛巾被
气味图书馆	气味	图书馆
水上音乐	水上	音乐
水感透白	水感	透白
水星家纺	水星	家纺
水晶秘密	水晶	秘密
水果诱惑	水果	诱惑
水洗面膜	水洗	面膜
水箱除味	水箱	除味
永恒之美	永恒	之美
江南布衣	江南	布衣
汽车美容	汽车	美容
汽车脚垫	汽车	脚垫
沃美WOME	沃美	wome
沙虫童装	沙虫	童装
法兰•卡	法兰	卡
法国Elgydium	法国	elgydium
法国大使	法国	大使
法国笑脸	法国	笑脸
泡沫先生	泡沫	先生
波司登内衣	波司登	内衣
波司登羽绒服	波司登	羽绒服
波斯宝娜	波斯	宝娜
波斯玫瑰	波斯	玫瑰
波比布朗	波比	布朗
波波小姐	波波	小姐
泰国宝贝	泰国	宝贝
洁面摩丝	洁面	摩丝
洗发护发	洗发	护发
洗发沐浴	洗发	沐浴
洗护商品	洗护	商品
洗护用品	洗护	用品
洗浴用品	洗浴	用品
洗车配件	洗车	配件
洗颜专科	洗颜	专科
测试品牌	测试	品牌
浪漫一身	浪漫	一身
浪漫时光	浪漫	时光
浪莎家访	浪莎	家访
浴室用品套装	浴室用品	套装
浴室配件	浴室	配件
海伦皇后	海伦	皇后
海洋之心	海洋	之心
海洋传说	海洋	传说
海洋离子	海洋	离子
海绵宝宝	海绵	宝宝
海绵泡泡	海绵	泡泡
海蓝之谜	海蓝之	谜
消除妊娠纹	消除	妊娠纹
淡化黑色素	淡化	黑色素
清凉凉鞋	清凉	凉鞋
清心雅韵	清心	雅韵
清洁工具	清洁工	具
渔夫堡FISHBURG	渔夫堡	fishburg
渔民部落	渔民	部落
游泳用品	游泳	用品
漂亮制造	漂亮	制造
漂亮百合	漂亮	百合
潮流街头	潮流	街头
澳洲咪咪	澳洲	咪咪
澳洲坚果	澳洲	坚果
澳洲袋鼠	澳洲	袋鼠
烧烤用品	烧烤	用品
烹饪工具	烹饪	工具
烹饪锅具	烹饪	锅具
熊猫panda	熊猫	panda
燕山甘栗仁	燕山	甘栗仁
爬行垫、毯	爬行垫	毯
爱与被爱	爱与	被爱
爱度珠宝	爱度	珠宝
爱的符号	爱的	符号
爱茉莉太平洋	爱茉莉	太平洋
牙医世家	牙医	世家
牙胶/安抚	牙胶	安抚
牛尔娜露可	牛尔	娜露可
牦牛世家	牦牛	世家
牵挂水晶项链	牵挂	水晶项链
特步户外	特步	户外
特殊配方	特殊	配方
特色市场	特色	市场
狐狸小姐	狐狸	小姐
狐臭净味水	狐臭	净味水
猫人裤袜	猫人	裤袜
猫&爱莎	猫	爱莎
玉兰油沐浴	玉兰油	沐浴
玉米小熊	玉米	小熊
王者风范	王者	风范
王薇拉VERA	王薇拉	vera
玛丽亚古琦	玛丽亚	古琦
玛丽·温莎	玛丽	温莎
玛莉吉亚	玛莉	吉亚
玩具服饰	玩具	服饰
玫瑰大道	玫瑰	大道
玫瑰柏拉图	玫瑰	柏拉图
玺之语珠宝	玺之语	珠宝
玻璃清洁	玻璃	清洁
玻璃美容	玻璃	美容
珂丽柏蒂	珂丽	柏蒂
珂兰钻石	珂兰	钻石
珍珠生活	珍珠	生活
珍珠皇后	珍珠	皇后
珍视明zhenshiming	珍视明	zhenshiming
珠宝黄金	珠宝	黄金
珠玉传奇	珠玉	传奇
琥珀研究所	琥珀	研究所
瑜伽发带	瑜伽	发带
瑜伽服上衣	瑜伽服	上衣
瑜伽服套装	瑜伽服	套装
瑜伽服装	瑜伽服	装
瑜伽用品	瑜伽	用品
瑜伽背包	瑜伽	背包
瑜伽胸垫	瑜伽	胸垫
瑞典北极狐	瑞典	北极狐
瑞士元素	瑞士	元素
瑞士军刀背包	瑞士军刀	背包
瑞士活泉	瑞士	活泉
瑞士纯净	瑞士	纯净
瑞娇Swissweda	瑞娇	swissweda
甘尼克宝贝	甘尼克	宝贝
甜杏仁油	甜杏仁	油
生活用品	生活	用品
生活电器	生活	电器
生活良品	生活	良品
电影周边	电影周	边
电脑护目镜	电脑	护目镜
电脑音乐	电脑	音乐
男休闲裤	男休闲	裤
男休闲鞋	男休闲	鞋
男士香水	男士	香水
男款运动袜	男款	运动袜
男牛仔裤	男牛仔	裤
男羽绒服	男羽绒	服
瘦大腿霜	瘦大腿	霜
瘦身医生	瘦身	医生
白色恋人	白色	恋人
百年丽人	百年	丽人
百年宝诚	百年	宝诚
百年纪念	百年	纪念
百度百丽	百度	百丽
百草童话	百草	童话
皇室玩具	皇室	玩具
皇家大道	皇家	大道
皇家花蜜	皇家	花蜜
皓顿Hautton	皓顿	hautton
皮具礼盒	皮具	礼盒
皮尔瑜伽	皮尔	瑜伽
皮毛一体	皮毛	一体
皮羽绒服	皮羽绒	服
皮肤专家	皮肤	专家
皮肤风衣	皮肤	风衣
益智玩具	益智	玩具
盖尔斯GUESS	盖尔斯	guess
相宜本草	相宜	本草
相框/相片墙	相框	相片墙
真情告白	真情	告白
真我永恒	真我	永恒
真皮皮衣	真皮皮	衣
眼唇卸妆	眼唇	卸妆
眼睫毛膏	眼睫毛	膏
眼线膏/胶	眼线膏	胶
眼袋自制	眼袋	自制
眼部护理	眼部	护理
眼部精华	眼部	精华
眼部造型	眼部	造型
睡眠博士	睡眠	博士
睡眠面膜	睡眠	面膜
睡衣上装	睡衣	上装
睡衣套装	睡衣	套装
睫毛增长	睫毛	增长
睫毛护理	睫毛	护理
睿智美人	睿智	美人
知识花园	知识	花园
短羽绒服	短羽绒	服
短袖连衣裙	短袖	连衣裙
礼品箱包	礼品	箱包
神秘卡米拉	神秘	卡米拉
神经酰胺	神经	酰胺
私密护理	私密	护理
秋衣秋裤	秋衣	秋裤
秘密符号	秘密	符号
移动电源	移动	电源
空中丽人	空中	丽人
空气净化	空气	净化
章鱼宝宝	章鱼	宝宝
童年时光	童年	时光
童装上装	童装	上装
童装下装	童装	下装
童装套装	童装	套装
童装童鞋	童装	童鞋
童车童床	童车	童床
第一乐章	第一	乐章
第一教室	第一	教室
第二次方	第二次	方
第五大道	第五	大道
简品100	简品	100
米兰达·可儿	米兰达	可儿
米奇丁当	米奇	丁当
米菲儿童	米菲	儿童
类似爱情	类似	爱情
糖果马车	糖果	马车
紫光电子	紫光	电子
红糖姜茶	红糖	姜茶
红豆童装	红豆	童装
纤体/美体	纤体	美体
纤体食品	纤体	食品
纯一良品	纯一	良品
纯净农庄	纯净	农庄
纯然Trunature	纯然	trunature
纯芦荟胶	纯芦荟	胶
纳瑞仕Nourish	纳瑞仕	nourish
纸巾盒/架	纸巾盒	架
纽约色彩	纽约	色彩
绅士企鹅	绅士	企鹅
细肤淡印霜	细肤	淡印霜
经典爱心	经典	爱心
绘画工具	绘画	工具
维科家纺	维科	家纺
维肌泉SkinVitals	维肌泉	skinvitals
绿野仙踪	绿野	仙踪
缩小毛孔	缩小	毛孔
缪诗 Mmuses	缪诗	mmuses
罗兰院长	罗兰	院长
美丽快攻	美丽	快攻
美丽诺言	美丽	诺言
美体小铺	美体	小铺
美体工具	美体	工具
美体考究	美体	考究
美发工具	美发	工具
美发造型	美发	造型
美国DUO	美国	duo
美国保罗	美国	保罗
美国小蜜蜂	美国	小蜜蜂
美国永恒	美国	永恒
美国箭牌	美国	箭牌
美国迪斯	美国	迪斯
美国队员	美国	队员
美家生活	美家	生活
美容仪器	美容仪	器
美容大王	美容大	王
美容工具	美容	工具
美帜丝巾	美帜	丝巾
美康粉黛	美康	粉黛
美思内衣	美思	内衣
美梦成真	美梦	成真
美泰托马斯	美泰	托马斯
美泰芭比	美泰	芭比
美甲工具	美甲	工具
美肌之志	美肌	之志
美肌美人	美肌	美人
美肌.美人	美肌	美人
美腿塑形袜	美腿	塑形袜
美蓝贝尔	美蓝	贝尔
美质原生	美质	原生
羚羊早安	羚羊	早安
羽毛球鞋	羽毛球	鞋
翘睫毛膏	翘睫毛	膏
翠玉生生	翠玉	生生
耐克360	耐克	360
联创电器	联创	电器
聚拢文胸	聚拢	文胸
聚美优品	聚美	优品
肉松/饼干	肉松	饼干
肉毒杆菌	肉毒	杆菌
肉类零食	肉类	零食
肌本清源	肌本	清源
肌肉医师	肌肉	医师
肌肤食品	肌肤	食品
肠胃调理	肠胃	调理
肤美灵skinice	肤美灵	skinice
肥皂盒牙刷架	肥皂盒	牙刷架
胶原蛋白	胶原	蛋白
膜法世家	膜法	世家
自主产品	自主	产品
自然之作	自然	之作
自然之宝	自然	之宝
自然之路	自然	之路
自然乐园	自然	乐园
自然哲理	自然	哲理
自然奇迹	自然	奇迹
自然晨露	自然	晨露
自由呼吸	自由	呼吸
自由天堂	自由	天堂
自由契约	自由	契约
舒适凉拖	舒适	凉拖
艾丽碧丝	艾丽	碧丝
艾格菲斯	艾格	菲斯
芒果服饰	芒果	服饰
芙蓉天使	芙蓉	天使
芬迪FENDI	芬迪	fendi
芭比娃娃	芭比	娃娃
芭比布朗	芭比	布朗
芭比波朗	芭比波	朗
花之使者	花之	使者
花花王子	花花	王子
花颜凝时	花颜	凝时
芳香假日	芳香	假日
苏菲SOFY	苏菲	sofy
苏菲长颈鹿	苏菲	长颈鹿
苏黎世家	苏黎世	家
苗条少女	苗条	少女
英国Meadows	英国	meadows
英国MJ	英国	mj
英国牛栏	英国	牛栏
范思哲牛仔	范思哲	牛仔
茱莉蔻Jurlique	茱莉蔻	jurlique
草木年华	草木	年华
草木良品	草木	良品
草本之源	草本	之源
草本美学	草本	美学
荷荷巴油	荷荷巴	油
荻嘉茂女装	荻嘉茂	女装
荻嘉茂家居服	荻嘉茂	家居服
荻嘉茂家纺	荻嘉茂	家纺
莎莉汉森	莎莉	汉森
莱文医生	莱文	医生
菲拉格慕	菲拉格	慕
菲斯小铺	菲斯	小铺
菲比寻常	菲比	寻常
菲诗小铺	菲诗	小铺
营养辅食	营养	辅食
蒂芬妮亚	蒂芬妮	亚
蒲公英粉	蒲公英	粉
蓝天白云	蓝天	白云
蓝色之恋	蓝色	之恋
蓝色和平	蓝色	和平
蓝色多瑙河	蓝色	多瑙河
蓝色天空	蓝色	天空
蓝色少女	蓝色	少女
蓝色巴士	蓝色	巴士
蓝色思维	蓝色	思维
蓝色恋人	蓝色	恋人
蓝色朋友们	蓝色	朋友们
薄羽绒服	薄羽绒	服
蛟蓓饰品	蛟蓓	饰品
蜡笔小胖	蜡笔	小胖
蝴蝶公主	蝴蝶	公主
螃蟹秘密	螃蟹	秘密
衣架/晾衣架	衣架	晾衣架
衣物清洁	衣物	清洁
补气养血	补气	养血
被子/夏凉被	被子	夏凉被
西洋打击乐器	西洋	打击乐器
西瑞尚品	西瑞	尚品
观雅guanya	观雅	guanya
詹妮弗_洛佩兹	詹妮弗	洛佩兹
训导玩具	训导	玩具
训练紧身衣	训练	紧身衣
训练紧身裤	训练	紧身裤
许愿精灵	许愿	精灵
诺依尔箱包	诺依尔	箱包
调整型文胸	调整型	文胸
调料器皿	调料	器皿
贝康小蜜蜂	贝康	小蜜蜂
贝拉小蜜蜂	贝拉	小蜜蜂
资生堂泊美	资生堂	泊美
资生堂菲婷	资生堂	菲婷
超人电器	超人	电器
超大容量	超大	容量
超级团购	超级	团购
越野跑鞋	越野	跑鞋
足部护理	足部	护理
路易威登	路易	威登
路易·威登	路易	威登
身体去角质	身体	去角质
身体护理	身体	护理
身体润肤	身体润	肤
身体清洁	身体	清洁
车用炭包	车用	炭包
车用香水	车用	香水
车载冰箱	车载	冰箱
车载净化器	车载	净化器
车载吸尘器	车载	吸尘器
车载电源	车载	电源
车钥匙包	车钥匙	包
轨道玩具	轨道	玩具
辅助用品	辅助	用品
运动休闲	运动	休闲
运动卫衣	运动	卫衣
运动卫裤	运动	卫裤
运动器械	运动	器械
运动夹克	运动	夹克
运动户外	运动	户外
运动毛衣	运动	毛衣
运动水壶	运动	水壶
运动沙滩鞋	运动	沙滩鞋
运动背心	运动	背心
运动长裤	运动	长裤
运动风衣	运动	风衣
运动马甲	运动	马甲
近江兄弟	近江	兄弟
进口水果	进口	水果
连体泳衣	连体	泳衣
迪士尼 Disney	迪士尼	disney
迪士尼宝宝	迪士尼	宝宝
迪芬娜girl	迪芬娜	girl
迪赛吉普	迪赛	吉普
迷你唐卡	迷你	唐卡
通用手套	通用	手套
速干背心	速干	背心
遥控电动	遥控	电动
遥控飞机	遥控	飞机
都市丽人	都市	丽人
野餐炊具	野餐	炊具
金巴黎Golden	金巴黎	golden
金龟子绿	金龟子	绿
针织背心	针织	背心
铁臂阿童木	铁臂	阿童木
银制产品	银制	产品
银座image	银座	image
银蝶炫舞	银蝶	炫舞
锅具配件	锅具	配件
闪电潮牌	闪电	潮牌
防晒乳液	防晒乳	液
防晒喷雾	防晒	喷雾
防晒隔离	防晒	隔离
防静脉曲张	防	静脉曲张
阳光少女	阳光	少女
阿曼贝丝	阿曼	贝丝
阿玛尼牛仔	阿玛尼	牛仔
雁皇家纺	雁皇	家纺
雅诗兰蒂	雅诗兰	蒂
雅诗兰黛	雅诗兰	黛
雏菊花语	雏菊	花语
雨伞雨具	雨伞	雨具
雨具配件	雨具	配件
雨披/雨衣	雨披	雨衣
霍霍巴油	霍霍巴	油
霸王洗发水	霸王	洗发水
青蛙王子	青蛙	王子
静脉曲张袜	静脉曲张	袜
非凡农庄	非凡	农庄
靠垫抱枕	靠垫	抱枕
面条/粥	面条	粥
面部去角质	面部	去角质
面部护肤	面部	护肤
韩国777	韩国	777
韩都衣舍	韩都	衣舍
颈枕/头枕	颈枕	头枕
颈部护理	颈部	护理
颜怡汉方	颜怡	汉方
风中花语	风中	花语
食具水具	食具	水具
食品保健	食品	保健
餐具套装	餐具	套装
餐具清洁剂	餐具	清洁剂
餐椅摇椅	餐椅	摇椅
饰品珠宝	饰品	珠宝
饰品配饰	饰品	配饰
饼干奶酪	饼干	奶酪
首饰套装	首饰	套装
首饰收纳盒	首饰	收纳盒
香榭丽舍	香榭丽	舍
香水套装	香水	套装
香港鳄鱼恤	香港	鳄鱼恤
香草巧克力	香草	巧克力
香蕉宝宝	香蕉	宝宝
香薰一族	香薰	一族
香薰蜡烛	香薰蜡	烛
马克尚顿	马克	尚顿
马克珍妮	马克	珍妮
马克·雅可布	马克	雅可布
马夹/背心	马夹	背心
马赛皂之家	马赛皂	之家
马连奴奥兰迪	马连奴	奥兰迪
驱虫用品	驱虫	用品
驱蚊手环	驱蚊	手环
骆驼动感	骆驼	动感
骆驼女装	骆驼	女装
骆驼女鞋	骆驼	女鞋
验孕测孕	验孕	测孕
骨骼补钙	骨骼	补钙
魅丽奇Payeasy	魅丽奇	payeasy
魅力女靴	魅力	女靴
魔力配方	魔力	配方
魔法医生	魔法	医生
魔法城堡	魔法	城堡
魔法森林	魔法	森林
魔盒NextBox	魔盒	nextbox
鱼嘴凉鞋	鱼嘴	凉鞋
鱼嘴单鞋	鱼嘴	单鞋
鲜果布衣	鲜果	布衣
鳄鱼宝宝	鳄鱼	宝宝
麦克棉花	麦克	棉花
黄金密码	黄金	密码
黑桃皇后	黑桃	皇后
